........
..***...
....O...
.X......
.X......
.X......
.....O..
........
