........
.....**.
........
.X......
.X......
.X......
..**....
.......O
